###########
#..###...##
##...#.##.#
#..#.#.#..#
###....####
#...###...#
#.#.....#.#
#########.#
